40 40 40 40 40 40 40 40 40 40
40 10 10 10 10 10 10 10 10 40
40 10 10 47 10 10 10 10 10 40
40 10 10 47 12 10 10 10 10 40
40 10 10 10 12 10 10 10 10 40
40 10 10 10 10 10 10 10 10 40
40 10 10 10 10 10 10 10 10 40
40 10 10 10 10 10 10 10 10 40
40 10 10 10 10 10 10 10 10 40
40 40 40 40 40 40 40 40 40 40