10 10 10 10 10 10 10 10 40 10 10 10 10 44 44 44 44 44 10 10 10 40 10 10 10 10 10 10 10 10
10 10 10 10 10 10 10 10 40 10 10 10 10 44 44 44 44 44 10 10 10 40 10 10 10 10 10 10 10 10
10 10 10 10 10 10 10 10 40 10 10 10 10 44 44 45 44 44 10 10 10 40 10 10 10 10 10 10 10 10
10 10 10 10 10 10 10 10 40 10 10 10 10 46 44 44 44 45 10 10 10 40 10 10 10 10 10 10 10 10
10 10 10 10 10 10 10 10 40 10 10 10 10 44 45 44 46 44 10 10 10 40 10 10 10 10 10 10 10 10
10 10 10 10 10 10 10 10 40 10 10 10 10 47 52 53 52 47 10 10 10 40 10 10 10 10 10 10 10 10
10 10 10 10 10 10 10 10 40 10 10 10 10 10 48 53 48 10 10 10 10 40 10 10 10 10 10 10 10 10
10 10 10 10 10 10 10 10 40 42 42 42 42 42 51 53 50 42 42 42 42 40 10 10 10 10 10 10 10 10
10 10 10 10 10 10 10 10 40 53 53 53 53 53 53 53 53 53 53 53 53 40 10 10 10 10 10 10 10 10
10 10 10 10 10 10 10 10 40 53 53 53 53 53 53 53 53 53 53 53 53 40 10 10 10 10 10 10 10 10
10 10 10 10 10 10 10 10 40 53 53 53 53 53 53 53 53 53 53 53 53 40 10 10 10 10 10 10 10 10
10 10 10 10 10 10 10 10 40 53 53 53 53 53 53 53 53 53 53 53 53 40 10 10 10 10 10 10 10 10
10 10 10 10 10 10 10 10 40 53 53 53 53 53 53 53 53 53 53 53 53 40 10 10 10 10 10 10 10 10
10 10 10 10 10 10 10 10 40 53 53 53 53 53 53 53 53 53 53 53 53 40 10 10 10 10 10 10 10 10
10 10 10 10 10 10 10 10 40 53 53 53 53 53 53 53 53 53 53 53 53 40 10 10 10 10 10 10 10 10
10 10 10 10 10 10 10 10 40 40 40 40 40 40 40 10 40 40 40 40 40 40 10 10 10 10 10 10 10 10
10 10 10 10 10 10 10 10 10 10 10 10 10 10 10 26 10 10 10 10 10 10 10 10 10 10 10 10 10 10
10 10 10 10 10 10 10 10 10 10 10 10 10 10 10 26 10 10 10 10 10 10 10 10 10 10 10 10 10 10
10 10 10 10 10 10 10 10 10 10 10 10 10 10 10 26 10 10 10 10 10 10 10 10 10 10 10 10 10 10
10 10 10 10 10 10 10 10 10 10 10 10 10 10 10 26 10 10 10 10 10 10 10 10 10 10 10 10 10 10
10 10 10 10 10 10 10 10 10 10 10 10 10 10 10 26 10 10 10 10 10 10 10 10 10 10 10 10 10 10